{
    "blocks": {
        "air": {
            "id": 0,
            "collision": false
        },
        "black": {
            "id": 1
        },
        "basic": {
            "id": 2
        }
    },
    "stage": [
        [0, 1, 0, 0, 0, 0, 0, 0, 0],
        [1, 1, 0, 1, 0, 0, 0, 0, 1],
        [1, 1, 0, 1, 0, 0, 0, 0, 1],
        [1, 1, 0, 1, 0, 0, 0, 0, 1, 1, 1, 1, 1, 1, 1, 1, 1, 1, 1, 1, 1, 1, 1, 1, 1],
        [1, 1, 0, 1, 0, 0, 0, 0, 1],
        [1, 1, 0, 1, 0, 0, 0, 0, 1],
        [1, 1, 0, 1, 0, 0, 0, 0, 1],
        [1, 1, 0, 1, 0, 0, 0, 0, 1],
        [1, 1, 0, 0, 0, 0, 0, 0, 1],
        [1, 1, 0, 1, 0, 0, 0, 0, 1],
        [1, 1, 0, 1, 0, 0, 0, 0, 1],
        [1, 1, 0, 1, 0, 0, 0, 0, 1],
        [1, 1, 0, 1, 0, 0, 0, 0, 1],
        [1, 1, 0, 1, 0, 0, 0, 0, 1],
        [1, 1, 1],
        [1, 0, 1],
        [1, 1, 1],
        [1, 1, 0, 0, 0, 0, 0, 0, 0, 0, 0, 0, 0, 0, 0, 0, 0, 0, 0, 0, 0, 0, 0, 0, 0, 0, 0, 0, 0, 0, 0, 0, 0, 0, 0, 0, 0, 0, 0, 0, 0, 0, 0, 0, 0, 0, 0, 0, 0, 0, 0, 0, 1],
        [1, 0, 0, 0, 0, 0, 0, 0, 0, 0, 0, 0, 0, 0, 0, 0, 0, 0, 0, 0, 0, 0, 0, 0, 0, 0, 0, 0, 0, 0, 0, 0, 0, 0, 0, 0, 0, 0, 0, 0, 0, 0, 0, 0, 0, 0, 0, 0, 0, 0, 0, 1],
        [1, 0, 0, 0, 0, 0, 0, 0, 0, 0, 0, 0, 0, 0, 0, 0, 0, 0, 0, 0, 0, 0, 0, 0, 0, 0, 0, 0, 0, 0, 0, 0, 0, 0, 0, 0, 0, 0, 0, 0, 0, 0, 0, 0, 0, 0, 0, 0, 0, 0, 0, 1],
        [1, 1, 0, 0, 0, 0, 0, 0, 0, 0, 0, 0, 0, 0, 0, 0, 0, 0, 0, 0, 0, 0, 0, 0, 0, 0, 0, 0, 0, 0, 0, 0, 0, 0, 0, 0, 0, 0, 0, 0, 0, 0, 0, 0, 0, 0, 0, 0, 0, 0, 0, 0, 1],
        [1, 1, 1, 1, 1, 0, 0, 0, 0, 0, 0, 0, 0, 0, 0, 0, 0, 0, 0, 0, 0, 0, 0, 0, 0, 0, 0, 0, 0, 0, 0, 0, 0, 0, 0, 0, 0, 0, 0, 0, 0, 0, 0, 0, 0, 0, 0, 0, 0, 0, 0, 0, 0, 0, 0, 1],
        [1, 1],
        [1, 1, 0, 0, 1],
        [0],
        [1, 1, 0, 0, 0, 0, 2, 2, 0, 0, 0, 0, 2, 0, 0, 0, 0, 2, 0, 0, 0, 0, 2, 0, 0, 0, 0, 2, 0, 0, 0, 0, 2, 0, 0, 0, 0, 2, 0, 0, 0, 0, 2, 0, 0, 0, 0, 2, 0, 0, 0, 0, 2, 0, 0, 0, 0, 2],
        [1, 0, 0, 0, 0, 0, 2, 2, 0, 0, 0, 0],
        [0],
        [1, 1],
        [1, 1],
        [1, 1],
        [1, 1],
        [1, 1],
        [0, 0],
        [0, 0],
        [0, 0],
        [1, 1],
        [1, 1],
        [1, 1, 0, 1, 1, 1, 1, 1, 2, 1, 2, 0, 1, 1, 1, 1, 1, 1, 1, 1, 1, 1],
        [1],
        [1],
        [1],
        [1],
        [1],
        [1],
        [1],
        [1]
    ]
}